+---+---+---+---+---+---+---+---+---+---+
|           |       |           |       |
+   +---+   +---+   +   +---+   +---+   +
|       |   |       |       |           |
+---+   +   +   +---+---+---+---+   +---+
|       |       |           |   |       |
+   +---+---+---+   +   +   +   +---+   +
|   |       |       |   |               |
+   +   +   +   +---+---+---+   +   +---+
|       |       |               |       |
+---+   +---+---+   +---+---+---+---+   +
|       |       |       |       |       |
+   +---+   +---+---+   +---+   +---+   +
|   |   |       |   |           |       |
+   +   +---+   +   +---+   +---+   +---+
|   |           |       |   |   |       |
+   +   +---+   +---+   +   +   +---+   +
|   |   |           |       |           |
+   +---+   +   +---+---+---+---+---+---+
|           |                           |
+---+---+---+---+---+---+---+---+---+---+