+---+---+---+---+---+---+---+---+---+---+
|       |           |                   |
+   +---+   +---+   +   +---+---+---+   +
|           |   |       |               |
+---+---+---+   +---+---+   +---+   +   +
|       |                   |   |   |   |
+---+   +   +   +---+---+---+   +   +   +
|       |   |       |       |       |   |
+   +---+   +---+   +   +   +---+---+---+
|           |       |   |       |       |
+---+---+---+   +---+---+---+   +   +   +
|       |       |               |   |   |
+   +   +   +---+   +---+---+---+---+   +
|   |       |           |   |       |   |
+   +---+---+   +---+   +   +   +   +   +
|   |       |   |       |       |   |   |
+   +   +   +---+   +---+---+---+   +   +
|   |   |           |       |       |   |
+   +   +---+---+---+   +   +   +---+   +
|                       |               |
+---+---+---+---+---+---+---+---+---+---+