+---+---+---+---+---+---+---+---+---+---+
|           |                       |   |
+---+   +   +---+---+   +---+---+   +   +
|       |       |       |           |   |
+   +---+---+   +   +---+   +---+   +   +
|       |       |   |   |       |   |   |
+---+   +   +---+   +   +---+   +   +   +
|   |   |       |   |   |       |       |
+   +   +---+   +   +   +   +---+---+---+
|       |       |   |       |       |   |
+   +---+   +---+   +---+---+---+   +   +
|   |   |           |           |   |   |
+   +   +---+---+---+   +---+   +   +   +
|           |       |   |   |   |       |
+---+   +   +   +   +   +   +   +   +   +
|       |   |   |   |       |       |   |
+   +---+   +   +   +---+---+   +---+   +
|   |       |   |               |       |
+   +   +---+   +---+---+---+---+   +---+
|   |           |                       |
+---+---+---+---+---+---+---+---+---+---+